"filename", "language", "C", "C++", "Markdown", "Makefile", "nasm", "comment", "blank", "total"
"/Users/huwenjie/Documents/cenneo-os-project/Makefile", "Makefile", 0, 0, 0, 64, 0, 17, 30, 111
"/Users/huwenjie/Documents/cenneo-os-project/Makefile.variable", "Makefile", 0, 0, 0, 62, 0, 8, 11, 81
"/Users/huwenjie/Documents/cenneo-os-project/README.md", "Markdown", 0, 0, 58, 0, 0, 0, 33, 91
"/Users/huwenjie/Documents/cenneo-os-project/applications/Console/Makefile", "Makefile", 0, 0, 0, 32, 0, 0, 16, 48
"/Users/huwenjie/Documents/cenneo-os-project/applications/Console/gfx.c", "C", 14, 0, 0, 0, 0, 0, 7, 21
"/Users/huwenjie/Documents/cenneo-os-project/applications/Console/loop.c", "C", 58, 0, 0, 0, 0, 5, 16, 79
"/Users/huwenjie/Documents/cenneo-os-project/applications/Console/main.c", "C", 12, 0, 0, 0, 0, 6, 12, 30
"/Users/huwenjie/Documents/cenneo-os-project/docs/Architecture.md", "Markdown", 0, 0, 28, 0, 0, 0, 8, 36
"/Users/huwenjie/Documents/cenneo-os-project/docs/FunctionList.md", "Markdown", 0, 0, 1, 0, 0, 0, 0, 1
"/Users/huwenjie/Documents/cenneo-os-project/docs/HowTo/CreateOS/index.md", "Markdown", 0, 0, 0, 0, 0, 0, 1, 1
"/Users/huwenjie/Documents/cenneo-os-project/docs/HowTo/ObtainInformation/index.md", "Markdown", 0, 0, 0, 0, 0, 0, 1, 1
"/Users/huwenjie/Documents/cenneo-os-project/docs/HowTo/Run/index.md", "Markdown", 0, 0, 43, 0, 0, 0, 37, 80
"/Users/huwenjie/Documents/cenneo-os-project/docs/HowTo/TeamWork/index.md", "Markdown", 0, 0, 0, 0, 0, 0, 1, 1
"/Users/huwenjie/Documents/cenneo-os-project/docs/Plan.md", "Markdown", 0, 0, 1, 0, 0, 0, 0, 1
"/Users/huwenjie/Documents/cenneo-os-project/docs/PreviousVersion.md", "Markdown", 0, 0, 2, 0, 0, 0, 1, 3
"/Users/huwenjie/Documents/cenneo-os-project/docs/Startup.md", "Markdown", 0, 0, 20, 0, 0, 0, 2, 22
"/Users/huwenjie/Documents/cenneo-os-project/docs/loader/loader.md", "Markdown", 0, 0, 7, 0, 0, 0, 3, 10
"/Users/huwenjie/Documents/cenneo-os-project/image/README.md", "Markdown", 0, 0, 8, 0, 0, 0, 5, 13
"/Users/huwenjie/Documents/cenneo-os-project/kernel/Architectures/README.md", "Markdown", 0, 0, 6, 0, 0, 0, 3, 9
"/Users/huwenjie/Documents/cenneo-os-project/kernel/Architectures/x86/CPU/CPU.c", "C", 116, 0, 0, 0, 0, 41, 17, 174
"/Users/huwenjie/Documents/cenneo-os-project/kernel/Architectures/x86/CPU/CPU.h", "C", 21, 0, 0, 0, 0, 16, 9, 46
"/Users/huwenjie/Documents/cenneo-os-project/kernel/Architectures/x86/_start.asm", "nasm", 0, 0, 0, 0, 179, 56, 30, 265
"/Users/huwenjie/Documents/cenneo-os-project/kernel/Architectures/x86/arch.c", "C", 35, 0, 0, 0, 0, 16, 13, 64
"/Users/huwenjie/Documents/cenneo-os-project/kernel/Architectures/x86/chips/cmos.c", "C", 26, 0, 0, 0, 0, 12, 7, 45
"/Users/huwenjie/Documents/cenneo-os-project/kernel/Architectures/x86/chips/i8254.c", "C", 82, 0, 0, 0, 0, 71, 26, 179
"/Users/huwenjie/Documents/cenneo-os-project/kernel/Architectures/x86/chips/i8259.c", "C", 47, 0, 0, 0, 0, 33, 12, 92
"/Users/huwenjie/Documents/cenneo-os-project/kernel/Architectures/x86/gdt.c", "C", 13, 0, 0, 0, 0, 4, 9, 26
"/Users/huwenjie/Documents/cenneo-os-project/kernel/Architectures/x86/include/cmos.h", "C", 51, 0, 0, 0, 0, 6, 6, 63
"/Users/huwenjie/Documents/cenneo-os-project/kernel/Architectures/x86/include/function.h", "C", 70, 0, 0, 0, 0, 30, 13, 113
"/Users/huwenjie/Documents/cenneo-os-project/kernel/Architectures/x86/include/gdt.h", "C", 7, 0, 0, 0, 0, 3, 7, 17
"/Users/huwenjie/Documents/cenneo-os-project/kernel/Architectures/x86/include/i8254.h", "C", 20, 0, 0, 0, 0, 15, 13, 48
"/Users/huwenjie/Documents/cenneo-os-project/kernel/Architectures/x86/include/i8259.h", "C", 22, 0, 0, 0, 0, 8, 6, 36
"/Users/huwenjie/Documents/cenneo-os-project/kernel/Architectures/x86/include/io.h", "C", 15, 0, 0, 0, 0, 16, 13, 44
"/Users/huwenjie/Documents/cenneo-os-project/kernel/Architectures/x86/include/mmu.h", "C", 33, 0, 0, 0, 0, 15, 21, 69
"/Users/huwenjie/Documents/cenneo-os-project/kernel/Architectures/x86/include/power.h", "C", 5, 0, 0, 0, 0, 5, 5, 15
"/Users/huwenjie/Documents/cenneo-os-project/kernel/Architectures/x86/include/x86ebi.h", "C", 111, 0, 0, 0, 0, 21, 27, 159
"/Users/huwenjie/Documents/cenneo-os-project/kernel/Architectures/x86/include/x86mmd.h", "C", 27, 0, 0, 0, 0, 11, 14, 52
"/Users/huwenjie/Documents/cenneo-os-project/kernel/Architectures/x86/include/x86mmd.inc", "nasm", 0, 0, 0, 0, 2, 1, 1, 4
"/Users/huwenjie/Documents/cenneo-os-project/kernel/Architectures/x86/include/x86types.h", "C", 12, 0, 0, 0, 0, 3, 5, 20
"/Users/huwenjie/Documents/cenneo-os-project/kernel/Architectures/x86/interrupt/entry.asm", "nasm", 0, 0, 0, 0, 132, 11, 11, 154
"/Users/huwenjie/Documents/cenneo-os-project/kernel/Architectures/x86/interrupt/exceptions.c", "C", 65, 0, 0, 0, 0, 19, 19, 103
"/Users/huwenjie/Documents/cenneo-os-project/kernel/Architectures/x86/interrupt/handle.c", "C", 10, 0, 0, 0, 0, 10, 4, 24
"/Users/huwenjie/Documents/cenneo-os-project/kernel/Architectures/x86/interrupt/interrupt.c", "C", 102, 0, 0, 0, 0, 23, 17, 142
"/Users/huwenjie/Documents/cenneo-os-project/kernel/Architectures/x86/interrupt/interrupt.h", "C", 92, 0, 0, 0, 0, 32, 31, 155
"/Users/huwenjie/Documents/cenneo-os-project/kernel/Architectures/x86/io.asm", "nasm", 0, 0, 0, 0, 57, 10, 6, 73
"/Users/huwenjie/Documents/cenneo-os-project/kernel/Architectures/x86/mmu/do_page_fault.c", "C", 29, 0, 0, 0, 0, 12, 10, 51
"/Users/huwenjie/Documents/cenneo-os-project/kernel/Architectures/x86/mmu/mmu.c", "C", 15, 0, 0, 0, 0, 6, 7, 28
"/Users/huwenjie/Documents/cenneo-os-project/kernel/Architectures/x86/mmu/paging.c", "C", 115, 0, 0, 0, 0, 24, 40, 179
"/Users/huwenjie/Documents/cenneo-os-project/kernel/Architectures/x86/mmu/pmb.c", "C", 114, 0, 0, 0, 0, 35, 42, 191
"/Users/huwenjie/Documents/cenneo-os-project/kernel/Architectures/x86/power.c", "C", 10, 0, 0, 0, 0, 7, 5, 22
"/Users/huwenjie/Documents/cenneo-os-project/kernel/Architectures/x86/syscalls.asm", "nasm", 0, 0, 0, 0, 37, 15, 13, 65
"/Users/huwenjie/Documents/cenneo-os-project/kernel/Architectures/x86/task/atomic.asm", "nasm", 0, 0, 0, 0, 36, 15, 9, 60
"/Users/huwenjie/Documents/cenneo-os-project/kernel/Architectures/x86/task/init_stack.asm", "nasm", 0, 0, 0, 0, 38, 11, 9, 58
"/Users/huwenjie/Documents/cenneo-os-project/kernel/Architectures/x86/task/spinlock.asm", "nasm", 0, 0, 0, 0, 5, 18, 6, 29
"/Users/huwenjie/Documents/cenneo-os-project/kernel/Architectures/x86/task/switch_to.asm", "nasm", 0, 0, 0, 0, 16, 15, 4, 35
"/Users/huwenjie/Documents/cenneo-os-project/kernel/Begin/Desktop/init.c", "C", 7, 0, 0, 0, 0, 9, 5, 21
"/Users/huwenjie/Documents/cenneo-os-project/kernel/Begin/Embedded/init.c", "C", 5, 0, 0, 0, 0, 4, 3, 12
"/Users/huwenjie/Documents/cenneo-os-project/kernel/Begin/Server/init.c", "C", 8, 0, 0, 0, 0, 6, 7, 21
"/Users/huwenjie/Documents/cenneo-os-project/kernel/Begin/begin.h", "C", 26, 0, 0, 0, 0, 3, 8, 37
"/Users/huwenjie/Documents/cenneo-os-project/kernel/Begin/main.c", "C", 63, 0, 0, 0, 0, 26, 33, 122
"/Users/huwenjie/Documents/cenneo-os-project/kernel/Console/Screen.c", "C", 129, 0, 0, 0, 0, 26, 29, 184
"/Users/huwenjie/Documents/cenneo-os-project/kernel/Console/theme.h", "C", 13, 0, 0, 0, 0, 3, 5, 21
"/Users/huwenjie/Documents/cenneo-os-project/kernel/Drivers/Keyboard.c", "C", 161, 0, 0, 0, 0, 47, 38, 246
"/Users/huwenjie/Documents/cenneo-os-project/kernel/Drivers/Mouse.c", "C", 104, 0, 0, 0, 0, 69, 39, 212
"/Users/huwenjie/Documents/cenneo-os-project/kernel/Drivers/acpi/acpi.c", "C", 6, 0, 0, 0, 0, 4, 3, 13
"/Users/huwenjie/Documents/cenneo-os-project/kernel/Drivers/acpi/sdt.c", "C", 51, 0, 0, 0, 0, 12, 19, 82
"/Users/huwenjie/Documents/cenneo-os-project/kernel/Drivers/graphics.c", "C", 22, 0, 0, 0, 0, 4, 8, 34
"/Users/huwenjie/Documents/cenneo-os-project/kernel/Drivers/i8042.c", "C", 81, 0, 0, 0, 0, 26, 23, 130
"/Users/huwenjie/Documents/cenneo-os-project/kernel/Drivers/ide/hdd.c", "C", 67, 0, 0, 0, 0, 30, 22, 119
"/Users/huwenjie/Documents/cenneo-os-project/kernel/Drivers/ide/hdd.h", "C", 128, 0, 0, 0, 0, 9, 11, 148
"/Users/huwenjie/Documents/cenneo-os-project/kernel/Drivers/network/rtl8139/rtl8139.c", "C", 988, 0, 0, 0, 0, 453, 291, 1732
"/Users/huwenjie/Documents/cenneo-os-project/kernel/Drivers/network/rtl8139/rtl8139.c.bak", "C", 131, 0, 0, 0, 0, 30, 52, 213
"/Users/huwenjie/Documents/cenneo-os-project/kernel/Drivers/pci/dev.c.bak", "C", 29, 0, 0, 0, 0, 4, 5, 38
"/Users/huwenjie/Documents/cenneo-os-project/kernel/Drivers/pci/pci.c", "C", 227, 0, 0, 0, 0, 38, 42, 307
"/Users/huwenjie/Documents/cenneo-os-project/kernel/Drivers/pci/pci.c.bak", "C", 161, 0, 0, 0, 0, 28, 40, 229
"/Users/huwenjie/Documents/cenneo-os-project/kernel/Drivers/virtio/virtio.c.bak", "C", 52, 0, 0, 0, 0, 15, 23, 90
"/Users/huwenjie/Documents/cenneo-os-project/kernel/FileSystem/cfs.c", "C", 7, 0, 0, 0, 0, 16, 5, 28
"/Users/huwenjie/Documents/cenneo-os-project/kernel/FileSystem/fat32/fat32.c", "C", 135, 0, 0, 0, 0, 28, 22, 185
"/Users/huwenjie/Documents/cenneo-os-project/kernel/FileSystem/fat32/fat32.h", "C", 16, 0, 0, 0, 0, 15, 11, 42
"/Users/huwenjie/Documents/cenneo-os-project/kernel/KernelMemory/kmalloc.c", "C", 96, 0, 0, 0, 0, 45, 29, 170
"/Users/huwenjie/Documents/cenneo-os-project/kernel/KernelMemory/kmalloc.h", "C", 21, 0, 0, 0, 0, 13, 8, 42
"/Users/huwenjie/Documents/cenneo-os-project/kernel/KernelMemory/kmm.c", "C", 47, 0, 0, 0, 0, 5, 15, 67
"/Users/huwenjie/Documents/cenneo-os-project/kernel/KernelMemory/kmm.md", "Markdown", 0, 0, 4, 0, 0, 0, 2, 6
"/Users/huwenjie/Documents/cenneo-os-project/kernel/KernelMemory/kmm_sm.h", "C", 26, 0, 0, 0, 0, 5, 9, 40
"/Users/huwenjie/Documents/cenneo-os-project/kernel/KernelMemory/vmalloc.c", "C", 89, 0, 0, 0, 0, 29, 26, 144
"/Users/huwenjie/Documents/cenneo-os-project/kernel/KernelMemory/vmap.c", "C", 18, 0, 0, 0, 0, 6, 7, 31
"/Users/huwenjie/Documents/cenneo-os-project/kernel/LogMonitor/klsm.c", "C", 49, 0, 0, 0, 0, 7, 17, 73
"/Users/huwenjie/Documents/cenneo-os-project/kernel/Makefile", "Makefile", 0, 0, 0, 45, 0, 9, 19, 73
"/Users/huwenjie/Documents/cenneo-os-project/kernel/README.md", "Markdown", 0, 0, 26, 0, 0, 0, 9, 35
"/Users/huwenjie/Documents/cenneo-os-project/kernel/cpp/support.cpp", "C++", 0, 14, 0, 0, 0, 32, 3, 49
"/Users/huwenjie/Documents/cenneo-os-project/kernel/gui/function.c", "C", 96, 0, 0, 0, 0, 40, 14, 150
"/Users/huwenjie/Documents/cenneo-os-project/kernel/gui/gui_api.c", "C", 19, 0, 0, 0, 0, 21, 9, 49
"/Users/huwenjie/Documents/cenneo-os-project/kernel/gui/init.c", "C", 39, 0, 0, 0, 0, 20, 15, 74
"/Users/huwenjie/Documents/cenneo-os-project/kernel/gui/layer.h", "C", 25, 0, 0, 0, 0, 17, 12, 54
"/Users/huwenjie/Documents/cenneo-os-project/kernel/gui/manage.c", "C", 146, 0, 0, 0, 0, 105, 64, 315
"/Users/huwenjie/Documents/cenneo-os-project/kernel/gui/recourse.h", "C", 26, 0, 0, 0, 0, 10, 9, 45
"/Users/huwenjie/Documents/cenneo-os-project/kernel/gui/refresh.c", "C", 56, 0, 0, 0, 0, 30, 15, 101
"/Users/huwenjie/Documents/cenneo-os-project/kernel/gui/window/lib.c", "C", 115, 0, 0, 0, 0, 69, 37, 221
"/Users/huwenjie/Documents/cenneo-os-project/kernel/gui/window/picture.c", "C", 122, 0, 0, 0, 0, 66, 44, 232
"/Users/huwenjie/Documents/cenneo-os-project/kernel/gui/window/task_bar.c", "C", 96, 0, 0, 0, 0, 45, 35, 176
"/Users/huwenjie/Documents/cenneo-os-project/kernel/gui/window/unit.c", "C", 47, 0, 0, 0, 0, 25, 17, 89
"/Users/huwenjie/Documents/cenneo-os-project/kernel/gui/window/unit.h", "C", 21, 0, 0, 0, 0, 16, 12, 49
"/Users/huwenjie/Documents/cenneo-os-project/kernel/gui/window/window.c", "C", 253, 0, 0, 0, 0, 149, 104, 506
"/Users/huwenjie/Documents/cenneo-os-project/kernel/gui/window/window.h", "C", 51, 0, 0, 0, 0, 56, 37, 144
"/Users/huwenjie/Documents/cenneo-os-project/kernel/includes/Console.h", "C", 4, 0, 0, 0, 0, 1, 5, 10
"/Users/huwenjie/Documents/cenneo-os-project/kernel/includes/acpi.h", "C", 51, 0, 0, 0, 0, 12, 15, 78
"/Users/huwenjie/Documents/cenneo-os-project/kernel/includes/arch.h", "C", 8, 0, 0, 0, 0, 8, 3, 19
"/Users/huwenjie/Documents/cenneo-os-project/kernel/includes/cfs.h", "C", 16, 0, 0, 0, 0, 8, 5, 29
"/Users/huwenjie/Documents/cenneo-os-project/kernel/includes/compiler.h", "C", 2, 0, 0, 0, 0, 0, 0, 2
"/Users/huwenjie/Documents/cenneo-os-project/kernel/includes/debug.h", "C", 30, 0, 0, 0, 0, 10, 10, 50
"/Users/huwenjie/Documents/cenneo-os-project/kernel/includes/drivers/Keyboard.h", "C", 7, 0, 0, 0, 0, 6, 6, 19
"/Users/huwenjie/Documents/cenneo-os-project/kernel/includes/drivers/i8042.h", "C", 17, 0, 0, 0, 0, 21, 15, 53
"/Users/huwenjie/Documents/cenneo-os-project/kernel/includes/drivers/pci.h", "C", 64, 0, 0, 0, 0, 52, 21, 137
"/Users/huwenjie/Documents/cenneo-os-project/kernel/includes/drivers/rtl8139.h", "C", 4, 0, 0, 0, 0, 3, 5, 12
"/Users/huwenjie/Documents/cenneo-os-project/kernel/includes/drivers/virtio.h", "C", 74, 0, 0, 0, 0, 63, 16, 153
"/Users/huwenjie/Documents/cenneo-os-project/kernel/includes/graphics.h", "C", 12, 0, 0, 0, 0, 3, 7, 22
"/Users/huwenjie/Documents/cenneo-os-project/kernel/includes/gui.h", "C", 28, 0, 0, 0, 0, 57, 27, 112
"/Users/huwenjie/Documents/cenneo-os-project/kernel/includes/hdd.h", "C", 8, 0, 0, 0, 0, 8, 6, 22
"/Users/huwenjie/Documents/cenneo-os-project/kernel/includes/info.h", "C", 9, 0, 0, 0, 0, 3, 4, 16
"/Users/huwenjie/Documents/cenneo-os-project/kernel/includes/inttypes.h", "C", 211, 0, 0, 0, 0, 18, 42, 271
"/Users/huwenjie/Documents/cenneo-os-project/kernel/includes/kls.h", "C", 13, 0, 0, 0, 0, 7, 10, 30
"/Users/huwenjie/Documents/cenneo-os-project/kernel/includes/kmm.h", "C", 25, 0, 0, 0, 0, 17, 17, 59
"/Users/huwenjie/Documents/cenneo-os-project/kernel/includes/kvi.h", "C", 13, 0, 0, 0, 0, 6, 9, 28
"/Users/huwenjie/Documents/cenneo-os-project/kernel/includes/lib/byteorder.h", "C", 86, 0, 0, 0, 0, 57, 17, 160
"/Users/huwenjie/Documents/cenneo-os-project/kernel/includes/lib/elf.h", "C", 73, 0, 0, 0, 0, 9, 13, 95
"/Users/huwenjie/Documents/cenneo-os-project/kernel/includes/lib/font.h", "C", 10, 0, 0, 0, 0, 12, 7, 29
"/Users/huwenjie/Documents/cenneo-os-project/kernel/includes/lib/gpl.h", "C", 19, 0, 0, 0, 0, 5, 9, 33
"/Users/huwenjie/Documents/cenneo-os-project/kernel/includes/lib/math.h", "C", 7, 0, 0, 0, 0, 23, 6, 36
"/Users/huwenjie/Documents/cenneo-os-project/kernel/includes/lib/string.h", "C", 21, 0, 0, 0, 0, 16, 10, 47
"/Users/huwenjie/Documents/cenneo-os-project/kernel/includes/lib/url.h", "C", 12, 0, 0, 0, 0, 0, 8, 20
"/Users/huwenjie/Documents/cenneo-os-project/kernel/includes/mmu.h", "C", 1, 0, 0, 0, 0, 0, 2, 3
"/Users/huwenjie/Documents/cenneo-os-project/kernel/includes/mouse.h", "C", 16, 0, 0, 0, 0, 18, 10, 44
"/Users/huwenjie/Documents/cenneo-os-project/kernel/includes/mpt/ipc.h", "C", 3, 0, 0, 0, 0, 0, 6, 9
"/Users/huwenjie/Documents/cenneo-os-project/kernel/includes/mpt/mpt.h", "C", 77, 0, 0, 0, 0, 24, 33, 134
"/Users/huwenjie/Documents/cenneo-os-project/kernel/includes/network/arch/bpstruct.h", "C", 2, 0, 0, 0, 0, 0, 1, 3
"/Users/huwenjie/Documents/cenneo-os-project/kernel/includes/network/arch/epstruct.h", "C", 1, 0, 0, 0, 0, 0, 1, 2
"/Users/huwenjie/Documents/cenneo-os-project/kernel/includes/network/arch/lwipopts.h", "C", 35, 0, 0, 0, 0, 36, 12, 83
"/Users/huwenjie/Documents/cenneo-os-project/kernel/includes/network/arch/sys_arch.h", "C", 31, 0, 0, 0, 0, 38, 11, 80
"/Users/huwenjie/Documents/cenneo-os-project/kernel/includes/network/compat/posix/arpa/inet.h", "C", 1, 0, 0, 0, 0, 30, 3, 34
"/Users/huwenjie/Documents/cenneo-os-project/kernel/includes/network/compat/posix/net/if.h", "C", 1, 0, 0, 0, 0, 33, 3, 37
"/Users/huwenjie/Documents/cenneo-os-project/kernel/includes/network/compat/posix/netdb.h", "C", 1, 0, 0, 0, 0, 30, 3, 34
"/Users/huwenjie/Documents/cenneo-os-project/kernel/includes/network/compat/posix/sys/socket.h", "C", 1, 0, 0, 0, 0, 30, 3, 34
"/Users/huwenjie/Documents/cenneo-os-project/kernel/includes/network/compat/stdc/errno.h", "C", 1, 0, 0, 0, 0, 30, 3, 34
"/Users/huwenjie/Documents/cenneo-os-project/kernel/includes/network/lwip/altcp.h", "C", 123, 0, 0, 0, 0, 45, 39, 207
"/Users/huwenjie/Documents/cenneo-os-project/kernel/includes/network/lwip/altcp_tcp.h", "C", 19, 0, 0, 0, 0, 41, 13, 73
"/Users/huwenjie/Documents/cenneo-os-project/kernel/includes/network/lwip/altcp_tls.h", "C", 34, 0, 0, 0, 0, 89, 21, 144
"/Users/huwenjie/Documents/cenneo-os-project/kernel/includes/network/lwip/api.h", "C", 238, 0, 0, 0, 0, 158, 36, 432
"/Users/huwenjie/Documents/cenneo-os-project/kernel/includes/network/lwip/apps/altcp_proxyconnect.h", "C", 27, 0, 0, 0, 0, 38, 15, 80
"/Users/huwenjie/Documents/cenneo-os-project/kernel/includes/network/lwip/apps/altcp_tls_mbedtls_opts.h", "C", 36, 0, 0, 0, 0, 54, 16, 106
"/Users/huwenjie/Documents/cenneo-os-project/kernel/includes/network/lwip/apps/fs.h", "C", 75, 0, 0, 0, 0, 38, 14, 127
"/Users/huwenjie/Documents/cenneo-os-project/kernel/includes/network/lwip/apps/http_client.h", "C", 56, 0, 0, 0, 0, 85, 20, 161
"/Users/huwenjie/Documents/cenneo-os-project/kernel/includes/network/lwip/apps/httpd.h", "C", 67, 0, 0, 0, 0, 159, 30, 256
"/Users/huwenjie/Documents/cenneo-os-project/kernel/includes/network/lwip/apps/httpd_opts.h", "C", 148, 0, 0, 0, 0, 197, 52, 397
"/Users/huwenjie/Documents/cenneo-os-project/kernel/includes/network/lwip/apps/lwiperf.h", "C", 39, 0, 0, 0, 0, 49, 13, 101
"/Users/huwenjie/Documents/cenneo-os-project/kernel/includes/network/lwip/apps/mdns.h", "C", 36, 0, 0, 0, 0, 48, 22, 106
"/Users/huwenjie/Documents/cenneo-os-project/kernel/includes/network/lwip/apps/mdns_opts.h", "C", 16, 0, 0, 0, 0, 54, 12, 82
"/Users/huwenjie/Documents/cenneo-os-project/kernel/includes/network/lwip/apps/mdns_priv.h", "C", 24, 0, 0, 0, 0, 39, 12, 75
"/Users/huwenjie/Documents/cenneo-os-project/kernel/includes/network/lwip/apps/mqtt.h", "C", 63, 0, 0, 0, 0, 114, 29, 206
"/Users/huwenjie/Documents/cenneo-os-project/kernel/includes/network/lwip/apps/mqtt_opts.h", "C", 28, 0, 0, 0, 0, 62, 14, 104
"/Users/huwenjie/Documents/cenneo-os-project/kernel/includes/network/lwip/apps/mqtt_priv.h", "C", 44, 0, 0, 0, 0, 52, 9, 105
"/Users/huwenjie/Documents/cenneo-os-project/kernel/includes/network/lwip/apps/netbiosns.h", "C", 15, 0, 0, 0, 0, 30, 7, 52
"/Users/huwenjie/Documents/cenneo-os-project/kernel/includes/network/lwip/apps/netbiosns_opts.h", "C", 10, 0, 0, 0, 0, 49, 8, 67
"/Users/huwenjie/Documents/cenneo-os-project/kernel/includes/network/lwip/apps/smtp.h", "C", 67, 0, 0, 0, 0, 43, 19, 129
"/Users/huwenjie/Documents/cenneo-os-project/kernel/includes/network/lwip/apps/smtp_opts.h", "C", 41, 0, 0, 0, 0, 23, 18, 82
"/Users/huwenjie/Documents/cenneo-os-project/kernel/includes/network/lwip/apps/snmp.h", "C", 59, 0, 0, 0, 0, 55, 22, 136
"/Users/huwenjie/Documents/cenneo-os-project/kernel/includes/network/lwip/apps/snmp_core.h", "C", 245, 0, 0, 0, 0, 77, 56, 378
"/Users/huwenjie/Documents/cenneo-os-project/kernel/includes/network/lwip/apps/snmp_mib2.h", "C", 31, 0, 0, 0, 0, 35, 13, 79
"/Users/huwenjie/Documents/cenneo-os-project/kernel/includes/network/lwip/apps/snmp_opts.h", "C", 96, 0, 0, 0, 0, 166, 36, 298
"/Users/huwenjie/Documents/cenneo-os-project/kernel/includes/network/lwip/apps/snmp_scalar.h", "C", 55, 0, 0, 0, 0, 40, 19, 114
"/Users/huwenjie/Documents/cenneo-os-project/kernel/includes/network/lwip/apps/snmp_snmpv2_framework.h", "C", 20, 0, 0, 0, 0, 3, 10, 33
"/Users/huwenjie/Documents/cenneo-os-project/kernel/includes/network/lwip/apps/snmp_snmpv2_usm.h", "C", 14, 0, 0, 0, 0, 3, 8, 25
"/Users/huwenjie/Documents/cenneo-os-project/kernel/includes/network/lwip/apps/snmp_table.h", "C", 70, 0, 0, 0, 0, 44, 21, 135
"/Users/huwenjie/Documents/cenneo-os-project/kernel/includes/network/lwip/apps/snmp_threadsync.h", "C", 55, 0, 0, 0, 0, 41, 19, 115
"/Users/huwenjie/Documents/cenneo-os-project/kernel/includes/network/lwip/apps/snmpv3.h", "C", 57, 0, 0, 0, 0, 37, 21, 115
"/Users/huwenjie/Documents/cenneo-os-project/kernel/includes/network/lwip/apps/sntp.h", "C", 32, 0, 0, 0, 0, 37, 12, 81
"/Users/huwenjie/Documents/cenneo-os-project/kernel/includes/network/lwip/apps/sntp_opts.h", "C", 63, 0, 0, 0, 0, 129, 24, 216
"/Users/huwenjie/Documents/cenneo-os-project/kernel/includes/network/lwip/apps/tftp_opts.h", "C", 26, 0, 0, 0, 0, 67, 14, 107
"/Users/huwenjie/Documents/cenneo-os-project/kernel/includes/network/lwip/apps/tftp_server.h", "C", 20, 0, 0, 0, 0, 67, 9, 96
"/Users/huwenjie/Documents/cenneo-os-project/kernel/includes/network/lwip/arch.h", "C", 184, 0, 0, 0, 0, 170, 43, 397
"/Users/huwenjie/Documents/cenneo-os-project/kernel/includes/network/lwip/autoip.h", "C", 35, 0, 0, 0, 0, 49, 16, 100
"/Users/huwenjie/Documents/cenneo-os-project/kernel/includes/network/lwip/debug.h", "C", 55, 0, 0, 0, 0, 88, 17, 160
"/Users/huwenjie/Documents/cenneo-os-project/kernel/includes/network/lwip/def.h", "C", 75, 0, 0, 0, 0, 60, 18, 153
"/Users/huwenjie/Documents/cenneo-os-project/kernel/includes/network/lwip/dhcp.h", "C", 71, 0, 0, 0, 0, 50, 19, 140
"/Users/huwenjie/Documents/cenneo-os-project/kernel/includes/network/lwip/dhcp6.h", "C", 38, 0, 0, 0, 0, 49, 18, 105
"/Users/huwenjie/Documents/cenneo-os-project/kernel/includes/network/lwip/dns.h", "C", 66, 0, 0, 0, 0, 48, 18, 132
"/Users/huwenjie/Documents/cenneo-os-project/kernel/includes/network/lwip/err.h", "C", 43, 0, 0, 0, 0, 63, 12, 118
"/Users/huwenjie/Documents/cenneo-os-project/kernel/includes/network/lwip/errno.h", "C", 147, 0, 0, 0, 0, 37, 15, 199
"/Users/huwenjie/Documents/cenneo-os-project/kernel/includes/network/lwip/etharp.h", "C", 42, 0, 0, 0, 0, 47, 17, 106
"/Users/huwenjie/Documents/cenneo-os-project/kernel/includes/network/lwip/ethip6.h", "C", 17, 0, 0, 0, 0, 39, 13, 69
"/Users/huwenjie/Documents/cenneo-os-project/kernel/includes/network/lwip/icmp.h", "C", 53, 0, 0, 0, 0, 45, 13, 111
"/Users/huwenjie/Documents/cenneo-os-project/kernel/includes/network/lwip/icmp6.h", "C", 23, 0, 0, 0, 0, 39, 11, 73
"/Users/huwenjie/Documents/cenneo-os-project/kernel/includes/network/lwip/if_api.h", "C", 22, 0, 0, 0, 0, 37, 12, 71
"/Users/huwenjie/Documents/cenneo-os-project/kernel/includes/network/lwip/igmp.h", "C", 40, 0, 0, 0, 0, 62, 14, 116
"/Users/huwenjie/Documents/cenneo-os-project/kernel/includes/network/lwip/inet.h", "C", 87, 0, 0, 0, 0, 55, 28, 170
"/Users/huwenjie/Documents/cenneo-os-project/kernel/includes/network/lwip/inet_chksum.h", "C", 51, 0, 0, 0, 0, 39, 16, 106
"/Users/huwenjie/Documents/cenneo-os-project/kernel/includes/network/lwip/init.h", "C", 32, 0, 0, 0, 0, 55, 14, 101
"/Users/huwenjie/Documents/cenneo-os-project/kernel/includes/network/lwip/ip.h", "C", 170, 0, 0, 0, 0, 123, 38, 331
"/Users/huwenjie/Documents/cenneo-os-project/kernel/includes/network/lwip/ip4.h", "C", 59, 0, 0, 0, 0, 36, 17, 112
"/Users/huwenjie/Documents/cenneo-os-project/kernel/includes/network/lwip/ip4_addr.h", "C", 110, 0, 0, 0, 0, 75, 32, 217
"/Users/huwenjie/Documents/cenneo-os-project/kernel/includes/network/lwip/ip4_frag.h", "C", 43, 0, 0, 0, 0, 44, 14, 101
"/Users/huwenjie/Documents/cenneo-os-project/kernel/includes/network/lwip/ip6.h", "C", 41, 0, 0, 0, 0, 39, 14, 94
"/Users/huwenjie/Documents/cenneo-os-project/kernel/includes/network/lwip/ip6_addr.h", "C", 212, 0, 0, 0, 0, 90, 51, 353
"/Users/huwenjie/Documents/cenneo-os-project/kernel/includes/network/lwip/ip6_frag.h", "C", 60, 0, 0, 0, 0, 66, 19, 145
"/Users/huwenjie/Documents/cenneo-os-project/kernel/includes/network/lwip/ip6_zone.h", "C", 76, 0, 0, 0, 0, 192, 37, 305
"/Users/huwenjie/Documents/cenneo-os-project/kernel/includes/network/lwip/ip_addr.h", "C", 258, 0, 0, 0, 0, 131, 50, 439
"/Users/huwenjie/Documents/cenneo-os-project/kernel/includes/network/lwip/mem.h", "C", 31, 0, 0, 0, 0, 38, 14, 83
"/Users/huwenjie/Documents/cenneo-os-project/kernel/includes/network/lwip/memp.h", "C", 66, 0, 0, 0, 0, 69, 21, 156
"/Users/huwenjie/Documents/cenneo-os-project/kernel/includes/network/lwip/mld6.h", "C", 33, 0, 0, 0, 0, 53, 14, 100
"/Users/huwenjie/Documents/cenneo-os-project/kernel/includes/network/lwip/nd6.h", "C", 34, 0, 0, 0, 0, 43, 14, 91
"/Users/huwenjie/Documents/cenneo-os-project/kernel/includes/network/lwip/netbuf.h", "C", 61, 0, 0, 0, 0, 41, 15, 117
"/Users/huwenjie/Documents/cenneo-os-project/kernel/includes/network/lwip/netdb.h", "C", 87, 0, 0, 0, 0, 42, 22, 151
"/Users/huwenjie/Documents/cenneo-os-project/kernel/includes/network/lwip/netif.h", "C", 376, 0, 0, 0, 0, 241, 57, 674
"/Users/huwenjie/Documents/cenneo-os-project/kernel/includes/network/lwip/netifapi.h", "C", 53, 0, 0, 0, 0, 91, 18, 162
"/Users/huwenjie/Documents/cenneo-os-project/kernel/includes/network/lwip/opt.h", "C", 1021, 0, 0, 0, 0, 2172, 334, 3527
"/Users/huwenjie/Documents/cenneo-os-project/kernel/includes/network/lwip/pbuf.h", "C", 132, 0, 0, 0, 0, 158, 37, 327
"/Users/huwenjie/Documents/cenneo-os-project/kernel/includes/network/lwip/priv/altcp_priv.h", "C", 98, 0, 0, 0, 0, 40, 22, 160
"/Users/huwenjie/Documents/cenneo-os-project/kernel/includes/network/lwip/priv/api_msg.h", "C", 177, 0, 0, 0, 0, 72, 24, 273
"/Users/huwenjie/Documents/cenneo-os-project/kernel/includes/network/lwip/priv/mem_priv.h", "C", 31, 0, 0, 0, 0, 43, 11, 85
"/Users/huwenjie/Documents/cenneo-os-project/kernel/includes/network/lwip/priv/memp_priv.h", "C", 82, 0, 0, 0, 0, 54, 26, 162
"/Users/huwenjie/Documents/cenneo-os-project/kernel/includes/network/lwip/priv/memp_std.h", "C", 87, 0, 0, 0, 0, 44, 23, 154
"/Users/huwenjie/Documents/cenneo-os-project/kernel/includes/network/lwip/priv/nd6_priv.h", "C", 71, 0, 0, 0, 0, 51, 21, 143
"/Users/huwenjie/Documents/cenneo-os-project/kernel/includes/network/lwip/priv/raw_priv.h", "C", 21, 0, 0, 0, 0, 37, 12, 70
"/Users/huwenjie/Documents/cenneo-os-project/kernel/includes/network/lwip/priv/sockets_priv.h", "C", 86, 0, 0, 0, 0, 70, 20, 176
"/Users/huwenjie/Documents/cenneo-os-project/kernel/includes/network/lwip/priv/tcp_priv.h", "C", 363, 0, 0, 0, 0, 84, 77, 524
"/Users/huwenjie/Documents/cenneo-os-project/kernel/includes/network/lwip/priv/tcpip_priv.h", "C", 121, 0, 0, 0, 0, 35, 15, 171
"/Users/huwenjie/Documents/cenneo-os-project/kernel/includes/network/lwip/prot/autoip.h", "C", 28, 0, 0, 0, 0, 42, 9, 79
"/Users/huwenjie/Documents/cenneo-os-project/kernel/includes/network/lwip/prot/dhcp.h", "C", 109, 0, 0, 0, 0, 48, 22, 179
"/Users/huwenjie/Documents/cenneo-os-project/kernel/includes/network/lwip/prot/dhcp6.h", "C", 76, 0, 0, 0, 0, 46, 17, 139
"/Users/huwenjie/Documents/cenneo-os-project/kernel/includes/network/lwip/prot/dns.h", "C", 77, 0, 0, 0, 0, 46, 18, 141
"/Users/huwenjie/Documents/cenneo-os-project/kernel/includes/network/lwip/prot/etharp.h", "C", 56, 0, 0, 0, 0, 47, 13, 116
"/Users/huwenjie/Documents/cenneo-os-project/kernel/includes/network/lwip/prot/ethernet.h", "C", 67, 0, 0, 0, 0, 43, 16, 126
"/Users/huwenjie/Documents/cenneo-os-project/kernel/includes/network/lwip/prot/iana.h", "C", 28, 0, 0, 0, 0, 62, 8, 98
"/Users/huwenjie/Documents/cenneo-os-project/kernel/includes/network/lwip/prot/icmp.h", "C", 42, 0, 0, 0, 0, 41, 9, 92
"/Users/huwenjie/Documents/cenneo-os-project/kernel/includes/network/lwip/prot/icmp6.h", "C", 83, 0, 0, 0, 0, 76, 14, 173
"/Users/huwenjie/Documents/cenneo-os-project/kernel/includes/network/lwip/prot/ieee.h", "C", 27, 0, 0, 0, 0, 58, 7, 92
"/Users/huwenjie/Documents/cenneo-os-project/kernel/includes/network/lwip/prot/igmp.h", "C", 36, 0, 0, 0, 0, 45, 10, 91
"/Users/huwenjie/Documents/cenneo-os-project/kernel/includes/network/lwip/prot/ip.h", "C", 16, 0, 0, 0, 0, 36, 8, 60
"/Users/huwenjie/Documents/cenneo-os-project/kernel/includes/network/lwip/prot/ip4.h", "C", 68, 0, 0, 0, 0, 51, 13, 132
"/Users/huwenjie/Documents/cenneo-os-project/kernel/includes/network/lwip/prot/ip6.h", "C", 153, 0, 0, 0, 0, 62, 21, 236
"/Users/huwenjie/Documents/cenneo-os-project/kernel/includes/network/lwip/prot/mld6.h", "C", 28, 0, 0, 0, 0, 37, 7, 72
"/Users/huwenjie/Documents/cenneo-os-project/kernel/includes/network/lwip/prot/nd6.h", "C", 204, 0, 0, 0, 0, 53, 18, 275
"/Users/huwenjie/Documents/cenneo-os-project/kernel/includes/network/lwip/prot/tcp.h", "C", 47, 0, 0, 0, 0, 41, 13, 101
"/Users/huwenjie/Documents/cenneo-os-project/kernel/includes/network/lwip/prot/udp.h", "C", 25, 0, 0, 0, 0, 36, 8, 69
"/Users/huwenjie/Documents/cenneo-os-project/kernel/includes/network/lwip/raw.h", "C", 63, 0, 0, 0, 0, 56, 25, 144
"/Users/huwenjie/Documents/cenneo-os-project/kernel/includes/network/lwip/sio.h", "C", 35, 0, 0, 0, 0, 92, 16, 143
"/Users/huwenjie/Documents/cenneo-os-project/kernel/includes/network/lwip/snmp.h", "C", 120, 0, 0, 0, 0, 72, 22, 214
"/Users/huwenjie/Documents/cenneo-os-project/kernel/includes/network/lwip/sockets.h", "C", 448, 0, 0, 0, 0, 165, 76, 689
"/Users/huwenjie/Documents/cenneo-os-project/kernel/includes/network/lwip/stats.h", "C", 349, 0, 0, 0, 0, 101, 42, 492
"/Users/huwenjie/Documents/cenneo-os-project/kernel/includes/network/lwip/sys.h", "C", 173, 0, 0, 0, 0, 341, 47, 561
"/Users/huwenjie/Documents/cenneo-os-project/kernel/includes/network/lwip/tcp.h", "C", 261, 0, 0, 0, 0, 164, 76, 501
"/Users/huwenjie/Documents/cenneo-os-project/kernel/includes/network/lwip/tcpbase.h", "C", 37, 0, 0, 0, 0, 38, 14, 89
"/Users/huwenjie/Documents/cenneo-os-project/kernel/includes/network/lwip/tcpip.h", "C", 49, 0, 0, 0, 0, 45, 20, 114
"/Users/huwenjie/Documents/cenneo-os-project/kernel/includes/network/lwip/timeouts.h", "C", 59, 0, 0, 0, 0, 51, 19, 129
"/Users/huwenjie/Documents/cenneo-os-project/kernel/includes/network/lwip/udp.h", "C", 102, 0, 0, 0, 0, 65, 29, 196
"/Users/huwenjie/Documents/cenneo-os-project/kernel/includes/network/netif/bridgeif.h", "C", 58, 0, 0, 0, 0, 56, 15, 129
"/Users/huwenjie/Documents/cenneo-os-project/kernel/includes/network/netif/bridgeif_opts.h", "C", 19, 0, 0, 0, 0, 60, 12, 91
"/Users/huwenjie/Documents/cenneo-os-project/kernel/includes/network/netif/etharp.h", "C", 2, 0, 0, 0, 0, 1, 1, 4
"/Users/huwenjie/Documents/cenneo-os-project/kernel/includes/network/netif/ethernet.h", "C", 22, 0, 0, 0, 0, 44, 13, 79
"/Users/huwenjie/Documents/cenneo-os-project/kernel/includes/network/netif/ieee802154.h", "C", 55, 0, 0, 0, 0, 49, 9, 113
"/Users/huwenjie/Documents/cenneo-os-project/kernel/includes/network/netif/lowpan6.h", "C", 32, 0, 0, 0, 0, 41, 17, 90
"/Users/huwenjie/Documents/cenneo-os-project/kernel/includes/network/netif/lowpan6_ble.h", "C", 30, 0, 0, 0, 0, 36, 13, 79
"/Users/huwenjie/Documents/cenneo-os-project/kernel/includes/network/netif/lowpan6_common.h", "C", 28, 0, 0, 0, 0, 42, 13, 83
"/Users/huwenjie/Documents/cenneo-os-project/kernel/includes/network/netif/lowpan6_opts.h", "C", 37, 0, 0, 0, 0, 69, 17, 123
"/Users/huwenjie/Documents/cenneo-os-project/kernel/includes/network/netif/ppp/ccp.h", "C", 84, 0, 0, 0, 0, 53, 28, 165
"/Users/huwenjie/Documents/cenneo-os-project/kernel/includes/network/netif/ppp/chap-md5.h", "C", 4, 0, 0, 0, 0, 29, 4, 37
"/Users/huwenjie/Documents/cenneo-os-project/kernel/includes/network/netif/ppp/chap-new.h", "C", 112, 0, 0, 0, 0, 64, 25, 201
"/Users/huwenjie/Documents/cenneo-os-project/kernel/includes/network/netif/ppp/chap_ms.h", "C", 8, 0, 0, 0, 0, 31, 6, 45
"/Users/huwenjie/Documents/cenneo-os-project/kernel/includes/network/netif/ppp/eap.h", "C", 111, 0, 0, 0, 0, 35, 24, 170
"/Users/huwenjie/Documents/cenneo-os-project/kernel/includes/network/netif/ppp/ecp.h", "C", 22, 0, 0, 0, 0, 32, 9, 63
"/Users/huwenjie/Documents/cenneo-os-project/kernel/includes/network/netif/ppp/eui64.h", "C", 48, 0, 0, 0, 0, 41, 14, 103
"/Users/huwenjie/Documents/cenneo-os-project/kernel/includes/network/netif/ppp/fsm.h", "C", 95, 0, 0, 0, 0, 66, 22, 183
"/Users/huwenjie/Documents/cenneo-os-project/kernel/includes/network/netif/ppp/ipcp.h", "C", 71, 0, 0, 0, 0, 48, 16, 135
"/Users/huwenjie/Documents/cenneo-os-project/kernel/includes/network/netif/ppp/ipv6cp.h", "C", 36, 0, 0, 0, 0, 143, 13, 192
"/Users/huwenjie/Documents/cenneo-os-project/kernel/includes/network/netif/ppp/lcp.h", "C", 107, 0, 0, 0, 0, 56, 17, 180
"/Users/huwenjie/Documents/cenneo-os-project/kernel/includes/network/netif/ppp/magic.h", "C", 17, 0, 0, 0, 0, 101, 13, 131
"/Users/huwenjie/Documents/cenneo-os-project/kernel/includes/network/netif/ppp/mppe.h", "C", 112, 0, 0, 0, 0, 53, 17, 182
"/Users/huwenjie/Documents/cenneo-os-project/kernel/includes/network/netif/ppp/polarssl/arc4.h", "C", 21, 0, 0, 0, 0, 51, 10, 82
"/Users/huwenjie/Documents/cenneo-os-project/kernel/includes/network/netif/ppp/polarssl/des.h", "C", 25, 0, 0, 0, 0, 56, 12, 93
"/Users/huwenjie/Documents/cenneo-os-project/kernel/includes/network/netif/ppp/polarssl/md4.h", "C", 23, 0, 0, 0, 0, 62, 13, 98
"/Users/huwenjie/Documents/cenneo-os-project/kernel/includes/network/netif/ppp/polarssl/md5.h", "C", 23, 0, 0, 0, 0, 62, 12, 97
"/Users/huwenjie/Documents/cenneo-os-project/kernel/includes/network/netif/ppp/polarssl/sha1.h", "C", 23, 0, 0, 0, 0, 62, 12, 97
"/Users/huwenjie/Documents/cenneo-os-project/kernel/includes/network/netif/ppp/ppp.h", "C", 371, 0, 0, 0, 0, 246, 82, 699
"/Users/huwenjie/Documents/cenneo-os-project/kernel/includes/network/netif/ppp/ppp_impl.h", "C", 408, 0, 0, 0, 0, 239, 76, 723
"/Users/huwenjie/Documents/cenneo-os-project/kernel/includes/network/netif/ppp/ppp_opts.h", "C", 250, 0, 0, 0, 0, 286, 82, 618
"/Users/huwenjie/Documents/cenneo-os-project/kernel/includes/network/netif/ppp/pppapi.h", "C", 99, 0, 0, 0, 0, 27, 12, 138
"/Users/huwenjie/Documents/cenneo-os-project/kernel/includes/network/netif/ppp/pppcrypt.h", "C", 79, 0, 0, 0, 0, 42, 24, 145
"/Users/huwenjie/Documents/cenneo-os-project/kernel/includes/network/netif/ppp/pppdebug.h", "C", 40, 0, 0, 0, 0, 36, 13, 89
"/Users/huwenjie/Documents/cenneo-os-project/kernel/includes/network/netif/ppp/pppoe.h", "C", 92, 0, 0, 0, 0, 70, 26, 188
"/Users/huwenjie/Documents/cenneo-os-project/kernel/includes/network/netif/ppp/pppol2tp.h", "C", 108, 0, 0, 0, 0, 63, 39, 210
"/Users/huwenjie/Documents/cenneo-os-project/kernel/includes/network/netif/ppp/pppos.h", "C", 51, 0, 0, 0, 0, 55, 21, 127
"/Users/huwenjie/Documents/cenneo-os-project/kernel/includes/network/netif/ppp/upap.h", "C", 52, 0, 0, 0, 0, 61, 19, 132
"/Users/huwenjie/Documents/cenneo-os-project/kernel/includes/network/netif/ppp/vj.h", "C", 71, 0, 0, 0, 0, 77, 22, 170
"/Users/huwenjie/Documents/cenneo-os-project/kernel/includes/network/netif/slipif.h", "C", 27, 0, 0, 0, 0, 50, 11, 88
"/Users/huwenjie/Documents/cenneo-os-project/kernel/includes/network/netif/zepif.h", "C", 24, 0, 0, 0, 0, 45, 13, 82
"/Users/huwenjie/Documents/cenneo-os-project/kernel/includes/page.h", "C", 7, 0, 0, 0, 0, 8, 5, 20
"/Users/huwenjie/Documents/cenneo-os-project/kernel/includes/spinlock.h", "C", 69, 0, 0, 0, 0, 41, 33, 143
"/Users/huwenjie/Documents/cenneo-os-project/kernel/includes/stdarg.h", "C", 8, 0, 0, 0, 0, 7, 5, 20
"/Users/huwenjie/Documents/cenneo-os-project/kernel/includes/stdbool.h", "C", 14, 0, 0, 0, 0, 5, 8, 27
"/Users/huwenjie/Documents/cenneo-os-project/kernel/includes/stddef.h", "C", 11, 0, 0, 0, 0, 13, 6, 30
"/Users/huwenjie/Documents/cenneo-os-project/kernel/includes/stdio.h", "C", 6, 0, 0, 0, 0, 7, 5, 18
"/Users/huwenjie/Documents/cenneo-os-project/kernel/includes/stdlib.h", "C", 4, 0, 0, 0, 0, 8, 3, 15
"/Users/huwenjie/Documents/cenneo-os-project/kernel/includes/syscalls.h", "C", 16, 0, 0, 0, 0, 12, 5, 33
"/Users/huwenjie/Documents/cenneo-os-project/kernel/includes/time.h", "C", 15, 0, 0, 0, 0, 8, 7, 30
"/Users/huwenjie/Documents/cenneo-os-project/kernel/includes/types.h", "C", 63, 0, 0, 0, 0, 5, 26, 94
"/Users/huwenjie/Documents/cenneo-os-project/kernel/includes/urm.h", "C", 24, 0, 0, 0, 0, 1, 13, 38
"/Users/huwenjie/Documents/cenneo-os-project/kernel/kls/kls.c", "C", 105, 0, 0, 0, 0, 45, 53, 203
"/Users/huwenjie/Documents/cenneo-os-project/kernel/lib/fonts/font.c", "C", 39, 0, 0, 0, 0, 22, 13, 74
"/Users/huwenjie/Documents/cenneo-os-project/kernel/lib/fonts/simsun.c", "C", 1462, 0, 0, 0, 0, 136, 5, 1603
"/Users/huwenjie/Documents/cenneo-os-project/kernel/lib/fonts/standard_font.c", "C", 4112, 0, 0, 0, 0, 264, 264, 4640
"/Users/huwenjie/Documents/cenneo-os-project/kernel/lib/gpl.c", "C", 139, 0, 0, 0, 0, 21, 22, 182
"/Users/huwenjie/Documents/cenneo-os-project/kernel/lib/math.c", "C", 26, 0, 0, 0, 0, 28, 6, 60
"/Users/huwenjie/Documents/cenneo-os-project/kernel/lib/rand.c", "C", 5, 0, 0, 0, 0, 0, 2, 7
"/Users/huwenjie/Documents/cenneo-os-project/kernel/lib/string.c", "C", 175, 0, 0, 0, 0, 108, 39, 322
"/Users/huwenjie/Documents/cenneo-os-project/kernel/lib/url/praser.c", "C", 105, 0, 0, 0, 0, 4, 21, 130
"/Users/huwenjie/Documents/cenneo-os-project/kernel/lib/vsprintf.c", "C", 732, 0, 0, 0, 0, 103, 132, 967
"/Users/huwenjie/Documents/cenneo-os-project/kernel/monitors/osm.c", "C", 107, 0, 0, 0, 0, 12, 25, 144
"/Users/huwenjie/Documents/cenneo-os-project/kernel/mpt/README.md", "Markdown", 0, 0, 14, 0, 0, 0, 6, 20
"/Users/huwenjie/Documents/cenneo-os-project/kernel/mpt/id.c", "C", 0, 0, 0, 0, 0, 3, 1, 4
"/Users/huwenjie/Documents/cenneo-os-project/kernel/mpt/ipc/message.c", "C", 62, 0, 0, 0, 0, 48, 24, 134
"/Users/huwenjie/Documents/cenneo-os-project/kernel/mpt/ipc/spinlock.c", "C", 64, 0, 0, 0, 0, 84, 26, 174
"/Users/huwenjie/Documents/cenneo-os-project/kernel/mpt/run.c", "C", 41, 0, 0, 0, 0, 23, 28, 92
"/Users/huwenjie/Documents/cenneo-os-project/kernel/mpt/task.c", "C", 136, 0, 0, 0, 0, 50, 50, 236
"/Users/huwenjie/Documents/cenneo-os-project/kernel/mqtt_demo/demo.c", "C", 33, 0, 0, 0, 0, 7, 13, 53
"/Users/huwenjie/Documents/cenneo-os-project/kernel/network/api/api_lib.c", "C", 828, 0, 0, 0, 0, 404, 136, 1368
"/Users/huwenjie/Documents/cenneo-os-project/kernel/network/api/api_msg.c", "C", 1591, 0, 0, 0, 0, 432, 154, 2177
"/Users/huwenjie/Documents/cenneo-os-project/kernel/network/api/err.c", "C", 62, 0, 0, 0, 0, 44, 10, 116
"/Users/huwenjie/Documents/cenneo-os-project/kernel/network/api/if_api.c", "C", 39, 0, 0, 0, 0, 56, 8, 103
"/Users/huwenjie/Documents/cenneo-os-project/kernel/network/api/netbuf.c", "C", 114, 0, 0, 0, 0, 118, 19, 251
"/Users/huwenjie/Documents/cenneo-os-project/kernel/network/api/netdb.c", "C", 256, 0, 0, 0, 0, 124, 38, 418
"/Users/huwenjie/Documents/cenneo-os-project/kernel/network/api/netifapi.c", "C", 218, 0, 0, 0, 0, 124, 39, 381
"/Users/huwenjie/Documents/cenneo-os-project/kernel/network/api/sockets.c", "C", 3262, 0, 0, 0, 0, 523, 382, 4167
"/Users/huwenjie/Documents/cenneo-os-project/kernel/network/api/tcpip.c", "C", 365, 0, 0, 0, 0, 225, 69, 659
"/Users/huwenjie/Documents/cenneo-os-project/kernel/network/apps/mqtt/mqtt.c", "C", 922, 0, 0, 0, 0, 378, 163, 1463
"/Users/huwenjie/Documents/cenneo-os-project/kernel/network/core/altcp.c", "C", 433, 0, 0, 0, 0, 220, 65, 718
"/Users/huwenjie/Documents/cenneo-os-project/kernel/network/core/altcp_alloc.c", "C", 31, 0, 0, 0, 0, 45, 12, 88
"/Users/huwenjie/Documents/cenneo-os-project/kernel/network/core/altcp_tcp.c", "C", 469, 0, 0, 0, 0, 60, 49, 578
"/Users/huwenjie/Documents/cenneo-os-project/kernel/network/core/def.c", "C", 118, 0, 0, 0, 0, 107, 16, 241
"/Users/huwenjie/Documents/cenneo-os-project/kernel/network/core/dns.c", "C", 1089, 0, 0, 0, 0, 416, 128, 1633
"/Users/huwenjie/Documents/cenneo-os-project/kernel/network/core/inet_chksum.c", "C", 327, 0, 0, 0, 0, 219, 63, 609
"/Users/huwenjie/Documents/cenneo-os-project/kernel/network/core/init.c", "C", 316, 0, 0, 0, 0, 49, 17, 382
"/Users/huwenjie/Documents/cenneo-os-project/kernel/network/core/ip.c", "C", 64, 0, 0, 0, 0, 90, 14, 168
"/Users/huwenjie/Documents/cenneo-os-project/kernel/network/core/ipv4/autoip.c", "C", 283, 0, 0, 0, 0, 189, 56, 528
"/Users/huwenjie/Documents/cenneo-os-project/kernel/network/core/ipv4/dhcp.c", "C", 1332, 0, 0, 0, 0, 477, 183, 1992
"/Users/huwenjie/Documents/cenneo-os-project/kernel/network/core/ipv4/etharp.c", "C", 675, 0, 0, 0, 0, 444, 94, 1213
"/Users/huwenjie/Documents/cenneo-os-project/kernel/network/core/ipv4/icmp.c", "C", 275, 0, 0, 0, 0, 106, 30, 411
"/Users/huwenjie/Documents/cenneo-os-project/kernel/network/core/ipv4/igmp.c", "C", 435, 0, 0, 0, 0, 262, 105, 802
"/Users/huwenjie/Documents/cenneo-os-project/kernel/network/core/ipv4/ip4.c", "C", 770, 0, 0, 0, 0, 267, 96, 1133
"/Users/huwenjie/Documents/cenneo-os-project/kernel/network/core/ipv4/ip4_addr.c", "C", 186, 0, 0, 0, 0, 114, 24, 324
"/Users/huwenjie/Documents/cenneo-os-project/kernel/network/core/ipv4/ip4_frag.c", "C", 559, 0, 0, 0, 0, 260, 76, 895
"/Users/huwenjie/Documents/cenneo-os-project/kernel/network/core/ipv6/dhcp6.c", "C", 527, 0, 0, 0, 0, 201, 94, 822
"/Users/huwenjie/Documents/cenneo-os-project/kernel/network/core/ipv6/ethip6.c", "C", 43, 0, 0, 0, 0, 67, 16, 126
"/Users/huwenjie/Documents/cenneo-os-project/kernel/network/core/ipv6/icmp6.c", "C", 225, 0, 0, 0, 0, 169, 41, 435
"/Users/huwenjie/Documents/cenneo-os-project/kernel/network/core/ipv6/inet6.c", "C", 6, 0, 0, 0, 0, 41, 7, 54
"/Users/huwenjie/Documents/cenneo-os-project/kernel/network/core/ipv6/ip6.c", "C", 988, 0, 0, 0, 0, 376, 131, 1495
"/Users/huwenjie/Documents/cenneo-os-project/kernel/network/core/ipv6/ip6_addr.c", "C", 226, 0, 0, 0, 0, 89, 29, 344
"/Users/huwenjie/Documents/cenneo-os-project/kernel/network/core/ipv6/ip6_frag.c", "C", 536, 0, 0, 0, 0, 243, 84, 863
"/Users/huwenjie/Documents/cenneo-os-project/kernel/network/core/ipv6/mld6.c", "C", 331, 0, 0, 0, 0, 214, 82, 627
"/Users/huwenjie/Documents/cenneo-os-project/kernel/network/core/ipv6/nd6.c", "C", 1573, 0, 0, 0, 0, 624, 250, 2447
"/Users/huwenjie/Documents/cenneo-os-project/kernel/network/core/mem.c", "C", 630, 0, 0, 0, 0, 290, 98, 1018
"/Users/huwenjie/Documents/cenneo-os-project/kernel/network/core/memp.c", "C", 285, 0, 0, 0, 0, 109, 54, 448
"/Users/huwenjie/Documents/cenneo-os-project/kernel/network/core/netif.c", "C", 1198, 0, 0, 0, 0, 412, 208, 1818
"/Users/huwenjie/Documents/cenneo-os-project/kernel/network/core/pbuf.c", "C", 781, 0, 0, 0, 0, 659, 109, 1549
"/Users/huwenjie/Documents/cenneo-os-project/kernel/network/core/raw.c", "C", 370, 0, 0, 0, 0, 252, 50, 672
"/Users/huwenjie/Documents/cenneo-os-project/kernel/network/core/stats.c", "C", 117, 0, 0, 0, 0, 36, 17, 170
"/Users/huwenjie/Documents/cenneo-os-project/kernel/network/core/sys.c", "C", 18, 0, 0, 0, 0, 122, 9, 149
"/Users/huwenjie/Documents/cenneo-os-project/kernel/network/core/tcp.c", "C", 1634, 0, 0, 0, 0, 827, 230, 2691
"/Users/huwenjie/Documents/cenneo-os-project/kernel/network/core/tcp_in.c", "C", 1415, 0, 0, 0, 0, 595, 170, 2180
"/Users/huwenjie/Documents/cenneo-os-project/kernel/network/core/tcp_out.c", "C", 1344, 0, 0, 0, 0, 615, 233, 2192
"/Users/huwenjie/Documents/cenneo-os-project/kernel/network/core/timeouts.c", "C", 284, 0, 0, 0, 0, 113, 55, 452
"/Users/huwenjie/Documents/cenneo-os-project/kernel/network/core/udp.c", "C", 807, 0, 0, 0, 0, 396, 118, 1321
"/Users/huwenjie/Documents/cenneo-os-project/kernel/network/netif/bridgeif.c", "C", 339, 0, 0, 0, 0, 171, 54, 564
"/Users/huwenjie/Documents/cenneo-os-project/kernel/network/netif/bridgeif_fdb.c", "C", 128, 0, 0, 0, 0, 66, 19, 213
"/Users/huwenjie/Documents/cenneo-os-project/kernel/network/netif/ethernet.c", "C", 201, 0, 0, 0, 0, 84, 35, 320
"/Users/huwenjie/Documents/cenneo-os-project/kernel/network/netif/lowpan6.c", "C", 599, 0, 0, 0, 0, 222, 100, 921
"/Users/huwenjie/Documents/cenneo-os-project/kernel/network/netif/lowpan6_ble.c", "C", 203, 0, 0, 0, 0, 199, 46, 448
"/Users/huwenjie/Documents/cenneo-os-project/kernel/network/netif/lowpan6_common.c", "C", 585, 0, 0, 0, 0, 184, 73, 842
"/Users/huwenjie/Documents/cenneo-os-project/kernel/network/netif/ppp/auth.c", "C", 1797, 0, 0, 0, 0, 468, 246, 2511
"/Users/huwenjie/Documents/cenneo-os-project/kernel/network/netif/ppp/ccp.c", "C", 1325, 0, 0, 0, 0, 277, 139, 1741
"/Users/huwenjie/Documents/cenneo-os-project/kernel/network/netif/ppp/chap-md5.c", "C", 81, 0, 0, 0, 0, 31, 15, 127
"/Users/huwenjie/Documents/cenneo-os-project/kernel/network/netif/ppp/chap-new.c", "C", 512, 0, 0, 0, 0, 94, 72, 678
"/Users/huwenjie/Documents/cenneo-os-project/kernel/network/netif/ppp/chap_ms.c", "C", 619, 0, 0, 0, 0, 217, 127, 963
"/Users/huwenjie/Documents/cenneo-os-project/kernel/network/netif/ppp/demand.c", "C", 336, 0, 0, 0, 0, 83, 47, 466
"/Users/huwenjie/Documents/cenneo-os-project/kernel/network/netif/ppp/eap.c", "C", 1901, 0, 0, 0, 0, 289, 234, 2424
"/Users/huwenjie/Documents/cenneo-os-project/kernel/network/netif/ppp/ecp.c", "C", 99, 0, 0, 0, 0, 75, 18, 192
"/Users/huwenjie/Documents/cenneo-os-project/kernel/network/netif/ppp/eui64.c", "C", 12, 0, 0, 0, 0, 39, 6, 57
"/Users/huwenjie/Documents/cenneo-os-project/kernel/network/netif/ppp/fsm.c", "C", 527, 0, 0, 0, 0, 164, 109, 800
"/Users/huwenjie/Documents/cenneo-os-project/kernel/network/netif/ppp/ipcp.c", "C", 1784, 0, 0, 0, 0, 387, 248, 2419
"/Users/huwenjie/Documents/cenneo-os-project/kernel/network/netif/ppp/ipv6cp.c", "C", 975, 0, 0, 0, 0, 379, 180, 1534
"/Users/huwenjie/Documents/cenneo-os-project/kernel/network/netif/ppp/lcp.c", "C", 2126, 0, 0, 0, 0, 430, 235, 2791
"/Users/huwenjie/Documents/cenneo-os-project/kernel/network/netif/ppp/magic.c", "C", 108, 0, 0, 0, 0, 161, 26, 295
"/Users/huwenjie/Documents/cenneo-os-project/kernel/network/netif/ppp/mppe.c", "C", 242, 0, 0, 0, 0, 118, 53, 413
"/Users/huwenjie/Documents/cenneo-os-project/kernel/network/netif/ppp/multilink.c", "C", 468, 0, 0, 0, 0, 80, 62, 610
"/Users/huwenjie/Documents/cenneo-os-project/kernel/network/netif/ppp/polarssl/arc4.c", "C", 42, 0, 0, 0, 0, 45, 15, 102
"/Users/huwenjie/Documents/cenneo-os-project/kernel/network/netif/ppp/polarssl/des.c", "C", 310, 0, 0, 0, 0, 73, 40, 423
"/Users/huwenjie/Documents/cenneo-os-project/kernel/network/netif/ppp/polarssl/md4.c", "C", 187, 0, 0, 0, 0, 55, 40, 282
"/Users/huwenjie/Documents/cenneo-os-project/kernel/network/netif/ppp/polarssl/md5.c", "C", 203, 0, 0, 0, 0, 54, 44, 301
"/Users/huwenjie/Documents/cenneo-os-project/kernel/network/netif/ppp/polarssl/sha1.c", "C", 237, 0, 0, 0, 0, 54, 45, 336
"/Users/huwenjie/Documents/cenneo-os-project/kernel/network/netif/ppp/ppp.c", "C", 1058, 0, 0, 0, 0, 399, 175, 1632
"/Users/huwenjie/Documents/cenneo-os-project/kernel/network/netif/ppp/pppapi.c", "C", 250, 0, 0, 0, 0, 121, 57, 428
"/Users/huwenjie/Documents/cenneo-os-project/kernel/network/netif/ppp/pppcrypt.c", "C", 22, 0, 0, 0, 0, 34, 11, 67
"/Users/huwenjie/Documents/cenneo-os-project/kernel/network/netif/ppp/pppoe.c", "C", 924, 0, 0, 0, 0, 153, 122, 1199
"/Users/huwenjie/Documents/cenneo-os-project/kernel/network/netif/ppp/pppol2tp.c", "C", 841, 0, 0, 0, 0, 182, 137, 1160
"/Users/huwenjie/Documents/cenneo-os-project/kernel/network/netif/ppp/pppos.c", "C", 615, 0, 0, 0, 0, 185, 96, 896
"/Users/huwenjie/Documents/cenneo-os-project/kernel/network/netif/ppp/upap.c", "C", 446, 0, 0, 0, 0, 141, 91, 678
"/Users/huwenjie/Documents/cenneo-os-project/kernel/network/netif/ppp/utils.c", "C", 747, 0, 0, 0, 0, 124, 87, 958
"/Users/huwenjie/Documents/cenneo-os-project/kernel/network/netif/ppp/vj.c", "C", 440, 0, 0, 0, 0, 184, 62, 686
"/Users/huwenjie/Documents/cenneo-os-project/kernel/network/netif/slipif.c.bak", "C", 310, 0, 0, 0, 0, 194, 55, 559
"/Users/huwenjie/Documents/cenneo-os-project/kernel/network/netif/zepif.c", "C", 205, 0, 0, 0, 0, 64, 32, 301
"/Users/huwenjie/Documents/cenneo-os-project/kernel/network/sys_arch.c", "C", 283, 0, 0, 0, 0, 47, 39, 369
"/Users/huwenjie/Documents/cenneo-os-project/kernel/scripts/script.cpp", "C++", 0, 4, 0, 0, 0, 8, 2, 14
"/Users/huwenjie/Documents/cenneo-os-project/kernel/time/time.c", "C", 21, 0, 0, 0, 0, 6, 9, 36
"/Users/huwenjie/Documents/cenneo-os-project/kernel/urm/init.c", "C", 11, 0, 0, 0, 0, 2, 7, 20
"/Users/huwenjie/Documents/cenneo-os-project/kernel/urm/protocol.c", "C", 15, 0, 0, 0, 0, 5, 10, 30
"/Users/huwenjie/Documents/cenneo-os-project/kernel/urm/queue.c", "C", 0, 0, 0, 0, 0, 0, 1, 1
"/Users/huwenjie/Documents/cenneo-os-project/kernel/urm/sys_urm.c", "C", 11, 0, 0, 0, 0, 0, 2, 13
"/Users/huwenjie/Documents/cenneo-os-project/kernel/urm/urm.c", "C", 127, 0, 0, 0, 0, 2, 29, 158
"/Users/huwenjie/Documents/cenneo-os-project/kernel/workspace/user/workspace.c", "C", 5, 0, 0, 0, 0, 0, 4, 9
"/Users/huwenjie/Documents/cenneo-os-project/loader/Makefile", "Makefile", 0, 0, 0, 9, 0, 11, 14, 34
"/Users/huwenjie/Documents/cenneo-os-project/loader/README.md", "Markdown", 0, 0, 136, 0, 0, 0, 20, 156
"/Users/huwenjie/Documents/cenneo-os-project/loader/boot/Makefile", "Makefile", 0, 0, 0, 43, 0, 12, 22, 77
"/Users/huwenjie/Documents/cenneo-os-project/loader/boot/README.md", "Markdown", 0, 0, 43, 0, 0, 0, 9, 52
"/Users/huwenjie/Documents/cenneo-os-project/loader/boot/arch/x86/_start.asm", "nasm", 0, 0, 0, 0, 6, 5, 3, 14
"/Users/huwenjie/Documents/cenneo-os-project/loader/boot/arch/x86/halt.asm", "nasm", 0, 0, 0, 0, 10, 7, 5, 22
"/Users/huwenjie/Documents/cenneo-os-project/loader/boot/arch/x86/include/interrupt.h", "C", 20, 0, 0, 0, 0, 6, 8, 34
"/Users/huwenjie/Documents/cenneo-os-project/loader/boot/arch/x86/include/types.h", "C", 11, 0, 0, 0, 0, 3, 5, 19
"/Users/huwenjie/Documents/cenneo-os-project/loader/boot/arch/x86/interrupt/entry.asm", "nasm", 0, 0, 0, 0, 73, 6, 4, 83
"/Users/huwenjie/Documents/cenneo-os-project/loader/boot/arch/x86/interrupt/handle.c", "C", 28, 0, 0, 0, 0, 8, 6, 42
"/Users/huwenjie/Documents/cenneo-os-project/loader/boot/arch/x86/interrupt/trap.asm", "nasm", 0, 0, 0, 0, 23, 10, 6, 39
"/Users/huwenjie/Documents/cenneo-os-project/loader/boot/arch/x86/io.asm", "nasm", 0, 0, 0, 0, 34, 5, 3, 42
"/Users/huwenjie/Documents/cenneo-os-project/loader/boot/boota.asm", "nasm", 0, 0, 0, 0, 19, 7, 5, 31
"/Users/huwenjie/Documents/cenneo-os-project/loader/boot/bootc.c", "C", 195, 0, 0, 0, 0, 57, 59, 311
"/Users/huwenjie/Documents/cenneo-os-project/loader/boot/elf.c", "C", 70, 0, 0, 0, 0, 9, 11, 90
"/Users/huwenjie/Documents/cenneo-os-project/loader/boot/elf.h", "C", 0, 0, 0, 0, 0, 0, 1, 1
"/Users/huwenjie/Documents/cenneo-os-project/loader/boot/fs.c", "C", 173, 0, 0, 0, 0, 42, 23, 238
"/Users/huwenjie/Documents/cenneo-os-project/loader/boot/includes/fs.h", "C", 20, 0, 0, 0, 0, 18, 14, 52
"/Users/huwenjie/Documents/cenneo-os-project/loader/boot/includes/head.h", "C", 116, 0, 0, 0, 0, 20, 26, 162
"/Users/huwenjie/Documents/cenneo-os-project/loader/boot/includes/io.h", "C", 12, 0, 0, 0, 0, 5, 7, 24
"/Users/huwenjie/Documents/cenneo-os-project/loader/boot/includes/irq.h", "C", 4, 0, 0, 0, 0, 0, 4, 8
"/Users/huwenjie/Documents/cenneo-os-project/loader/boot/includes/lib/color.h", "C", 458, 0, 0, 0, 0, 3, 4, 465
"/Users/huwenjie/Documents/cenneo-os-project/loader/boot/includes/lib/font.h", "C", 7, 0, 0, 0, 0, 2, 4, 13
"/Users/huwenjie/Documents/cenneo-os-project/loader/boot/includes/lib/graphics.h", "C", 23, 0, 0, 0, 0, 14, 14, 51
"/Users/huwenjie/Documents/cenneo-os-project/loader/boot/includes/lib/math.h", "C", 4, 0, 0, 0, 0, 9, 4, 17
"/Users/huwenjie/Documents/cenneo-os-project/loader/boot/includes/lib/mem.h", "C", 6, 0, 0, 0, 0, 8, 4, 18
"/Users/huwenjie/Documents/cenneo-os-project/loader/boot/includes/lib/stdarg.h", "C", 8, 0, 0, 0, 0, 7, 5, 20
"/Users/huwenjie/Documents/cenneo-os-project/loader/boot/includes/lib/stdbool.h", "C", 13, 0, 0, 0, 0, 5, 8, 26
"/Users/huwenjie/Documents/cenneo-os-project/loader/boot/includes/lib/stdio.h", "C", 6, 0, 0, 0, 0, 8, 6, 20
"/Users/huwenjie/Documents/cenneo-os-project/loader/boot/includes/lib/stdlib.h", "C", 4, 0, 0, 0, 0, 8, 4, 16
"/Users/huwenjie/Documents/cenneo-os-project/loader/boot/includes/lib/string.h", "C", 17, 0, 0, 0, 0, 19, 13, 49
"/Users/huwenjie/Documents/cenneo-os-project/loader/boot/includes/math.h", "C", 4, 0, 0, 0, 0, 9, 3, 16
"/Users/huwenjie/Documents/cenneo-os-project/loader/boot/includes/mmu.h", "C", 4, 0, 0, 0, 0, 3, 3, 10
"/Users/huwenjie/Documents/cenneo-os-project/loader/boot/includes/script.h", "C", 13, 0, 0, 0, 0, 8, 8, 29
"/Users/huwenjie/Documents/cenneo-os-project/loader/boot/includes/storage.h", "C", 35, 0, 0, 0, 0, 18, 18, 71
"/Users/huwenjie/Documents/cenneo-os-project/loader/boot/includes/vi.h", "C", 28, 0, 0, 0, 0, 23, 22, 73
"/Users/huwenjie/Documents/cenneo-os-project/loader/boot/lib/font.c", "C", 2689, 0, 0, 0, 0, 264, 279, 3232
"/Users/huwenjie/Documents/cenneo-os-project/loader/boot/lib/graphics.c", "C", 146, 0, 0, 0, 0, 25, 21, 192
"/Users/huwenjie/Documents/cenneo-os-project/loader/boot/lib/math.c", "C", 6, 0, 0, 0, 0, 9, 3, 18
"/Users/huwenjie/Documents/cenneo-os-project/loader/boot/lib/mem.c", "C", 34, 0, 0, 0, 0, 33, 7, 74
"/Users/huwenjie/Documents/cenneo-os-project/loader/boot/lib/string.c", "C", 149, 0, 0, 0, 0, 74, 35, 258
"/Users/huwenjie/Documents/cenneo-os-project/loader/boot/lib/vsprintf.c", "C", 493, 0, 0, 0, 0, 56, 85, 634
"/Users/huwenjie/Documents/cenneo-os-project/loader/boot/mmu.c", "C", 19, 0, 0, 0, 0, 6, 4, 29
"/Users/huwenjie/Documents/cenneo-os-project/loader/boot/script.c", "C", 42, 0, 0, 0, 0, 10, 22, 74
"/Users/huwenjie/Documents/cenneo-os-project/loader/boot/setup.asm", "nasm", 0, 0, 0, 0, 157, 52, 28, 237
"/Users/huwenjie/Documents/cenneo-os-project/loader/boot/storage.c", "C", 276, 0, 0, 0, 0, 87, 82, 445
"/Users/huwenjie/Documents/cenneo-os-project/loader/boot/vi.c", "C", 438, 0, 0, 0, 0, 168, 145, 751
"/Users/huwenjie/Documents/cenneo-os-project/loader/configure.h", "C", 41, 0, 0, 0, 0, 7, 9, 57
"/Users/huwenjie/Documents/cenneo-os-project/loader/mbr/Makefile", "Makefile", 0, 0, 0, 12, 0, 4, 12, 28
"/Users/huwenjie/Documents/cenneo-os-project/loader/mbr/README.md", "Markdown", 0, 0, 16, 0, 0, 0, 6, 22
"/Users/huwenjie/Documents/cenneo-os-project/loader/mbr/mbr.asm", "nasm", 0, 0, 0, 0, 65, 29, 23, 117
"/Users/huwenjie/Documents/cenneo-os-project/loader/problem.h", "C", 14, 0, 0, 0, 0, 4, 6, 24
"/Users/huwenjie/Documents/cenneo-os-project/tools/appbase/Makefile", "Makefile", 0, 0, 0, 34, 0, 0, 15, 49
"/Users/huwenjie/Documents/cenneo-os-project/tools/appbase/base.asm", "nasm", 0, 0, 0, 0, 18, 0, 5, 23
"/Users/huwenjie/Documents/cenneo-os-project/tools/appbase/includes/apis/gui.h", "C", 0, 0, 0, 0, 0, 0, 1, 1
"/Users/huwenjie/Documents/cenneo-os-project/tools/appbase/includes/cnos_scheme.h", "C", 20, 0, 0, 0, 0, 0, 8, 28
"/Users/huwenjie/Documents/cenneo-os-project/tools/appbase/includes/cnos_urm.h", "C", 4, 0, 0, 0, 0, 0, 4, 8
"/Users/huwenjie/Documents/cenneo-os-project/tools/appbase/includes/math.h", "C", 4, 0, 0, 0, 0, 9, 3, 16
"/Users/huwenjie/Documents/cenneo-os-project/tools/appbase/includes/stddef.h", "C", 6, 0, 0, 0, 0, 8, 4, 18
"/Users/huwenjie/Documents/cenneo-os-project/tools/appbase/includes/stdio.h", "C", 8, 0, 0, 0, 0, 7, 6, 21
"/Users/huwenjie/Documents/cenneo-os-project/tools/appbase/includes/stdlib.h", "C", 5, 0, 0, 0, 0, 0, 6, 11
"/Users/huwenjie/Documents/cenneo-os-project/tools/appbase/includes/string.h", "C", 19, 0, 0, 0, 0, 15, 10, 44
"/Users/huwenjie/Documents/cenneo-os-project/tools/appbase/includes/syscall.h", "C", 12, 0, 0, 0, 0, 0, 6, 18
"/Users/huwenjie/Documents/cenneo-os-project/tools/appbase/init.c", "C", 4, 0, 0, 0, 0, 0, 6, 10
"/Users/huwenjie/Documents/cenneo-os-project/tools/appbase/stdlib.c", "C", 7, 0, 0, 0, 0, 0, 6, 13
"/Users/huwenjie/Documents/cenneo-os-project/tools/appbase/string.c", "C", 169, 0, 0, 0, 0, 90, 37, 296
"/Users/huwenjie/Documents/cenneo-os-project/tools/appbase/urm.c", "C", 8, 0, 0, 0, 0, 0, 5, 13
"/Users/huwenjie/Documents/cenneo-os-project/tools/appbase/vsprintf.c", "C", 736, 0, 0, 0, 0, 60, 130, 926
"/Users/huwenjie/Documents/cenneo-os-project/tools/gfr/Makefile", "Makefile", 0, 0, 0, 20, 0, 9, 11, 40
"/Users/huwenjie/Documents/cenneo-os-project/tools/gfr/README.md", "Markdown", 0, 0, 24, 0, 0, 0, 7, 31
"/Users/huwenjie/Documents/cenneo-os-project/tools/gfr/gfr.c", "C", 155, 0, 0, 0, 0, 54, 40, 249
"/Users/huwenjie/Documents/cenneo-os-project/tools/gfr/include/config.h", "C", 3, 0, 0, 0, 0, 11, 6, 20
"/Users/huwenjie/Documents/cenneo-os-project/tools/gfr/include/info.h", "C", 5, 0, 0, 0, 0, 11, 4, 20
"/Users/huwenjie/Documents/cenneo-os-project/tools/gfr/include/return.h", "C", 5, 0, 0, 0, 0, 11, 4, 20
"/Users/huwenjie/Documents/cenneo-os-project/tools/gfr/type/img.c", "C", 0, 0, 0, 0, 0, 0, 3, 3
"/Users/huwenjie/Documents/cenneo-os-project/tools/gfr/type/vhd.c", "C", 0, 0, 0, 0, 0, 0, 3, 3
"Total", "-", 84382, 18, 437, 321, 907, 36589, 15695, 138349